11111111111111111111
10001701000011000001
10101011101111001101
10001000000000011001
10101111111111110011
10006000000006010101
11000011111111010101
10050011100001116101
10111111101111000001
10000000001001006001
11110111101001111001
11100110001030100001
11001111111001111101
10011000011060000001
10111110011001111111
10030000000000003001
10110111106011111111
10110011000001111001
17000000005000000071
11111111111111111111