11111111111111111111
10001001000011002001
10100011101111001101
10110000002000011001
10311111111111110211
10000000000000010171
11103011111111010101
10000011100001110101
10111111101111000021
10200000001321000001
11110111101001111001
11100110001000100001
11001111111001111101
10011700011000000001
10111110011001111111
10000000000000000001
10110111102011111111
10110011000001111001
17003000003000200071
11111111111111111111