11111111111111111111
10010110111100111071
10110100000003000011
10100111111111100111
10000000003130000301
10030000000000001001
11011100005000101001
10001000011110001001
10100005010000111071
10001000000110111111
11101005010110003001
10001001110111001111
11110000010001050001
10000111100100100701
10100001100111111111
10000000000000000001
10101000011100050001
10101100111110000101
10030000003000500071
11111111111111111111